11111111111111111111111111111111
10C0C0C000010000C000C0000C000C01
101110R1110R0111101110100C000C01
101110R1110R0111101110100C0R0C01
10000000000P000R0000001000000001
101110101111111010111010011R1111
10C0001C000E00001000C01R010001C1
11111000111111101011111001010101
1C0000R0000C0000000C0000R1010101
10111011110101111011101000010001
11111111111111111111111111111111