1111111111
1000000C01
100001R001
1PEC000001
100000RC11
1111111111