11111111111111111111111
10C0C0C000010000C000C01
10100R111101011110R1101
10111011110101111001101
10000000000P00000000001
1000R010111111R01011101
10C0001C000E00001000C01
11111111111111111111111